NO ./textures/north.xpm
SO ./textures/south.xpm
WE ./textures/west.xpm
EA ./textures/east.xpm
F 220,100,0
C 225,30,0

111111111
1 00000 1
1 01110 1
1 01N10 1
1 01110 1
1 00000 1
111111111
